date,snickers,twix,3m,milk,milkd,total
2/3/2020,4,5,3,2,0,14
2/5/2020,5,5,3,1,2,16
2/10/2020,5,8,4,3,3,23
2/12/2020,7,6,7,6,6,32
2/17/2020,8,10,5,3,12,38
2/19/2020,11,9,5,12,3,40
2/24/2020,9,12,3,8,2,34
2/26/2020,2,3,1,3,1,10
3/2/2020,4,6,1,2,2,15
3/5/2020,6,9,6,7,7,35
3/9/2020,8,11,2,5,7,33
3/11/2020,5,4,4,5,4,22
